@@@@@@@@@@@@@@@@@@@@@@@@@@@@@@@@@@@@@@@@@@@@@@@@@@@@@@@@@@@@@@@@
@..............................................................@
@..............................................................@
@..@..@..@@@@@@@@..@@@@..@@@@@@@@@..@@@@@@@..@..@@@@@@@@..@@@..@
@..@..@.........@.....@......@......@........@.........@....@..@
@.. ..@.........@.....@......@......@........@.........@....@..@
@.....@@@@@..@..@@@@..@@@@@..@..@@@@@..@..@@@@@@@@@@@..@@@.....@
@..@.........@.....@...................@.................@.....@
@..@.........@.....@...................@.................@@@@..@
@..@@@@@@@@@@@@@@..@@@@@@@..@@@@@@..@@@@@@@..@@@@..@@@@..@.....@
@...........@..........................@.................@.....@
@...........@..........................@.................@..@..@
@..@@@@@@@..@..@@@@@@@@..@@@@@..@@@@@..@..@@@@..@@@@@@@@@@..@..@
@..@.....@..@...@.....@......................@...........@..@..@
@..@.....@..@...@.....@......................@...........@.....@
@..@..@..@..@@..@..@..@..@@@@@@@@@@@@..@@@@..@@@@@..@@@..@.....@
@..@..@............@...................@............@....@@@@..@
@..@..@............@...................@............@....@.....@
@..@..@@@@@@@@@@@@@@..@..@@@@@..@@@@@..@..@@@@@..@@@@..@@@.....@
@..@..@..........@....@......@..@...................@.......@..@
@..@..@..........@....@......@..@...................@.......@..@
@..@..@..@@@..@..@..@@@@@@@..@..@..@@..@@@@@@@@@@@..@@..@@@@@..@
@..@..@.......@..........................................@.....@
@..@..@.......@................................................@
@........@@@@@@@@@@@..@@..@..@@@@@@..@@@@@@@@@..@@@@@@@.....@..@
@.........................@....@.........@...............@@@@..@
@..@..@...................@....@.........@...............@.....@
@..@..@@@@@@@@@..@@@@@..@@@@@..@..@@@@@..@..@@@@@..@..@@@@.....@
@..@......@..........@....@....@............@......@........@..@
@..@......@..........@....@....@............@......@........@..@
@..@@@@@..@..@@@@@@..@@@..@..@@@@@@@..@@@@@@@..@@..@..@@..@@@..@
@..............................................................@
@..............................................................@
@@@@@@@@@@@@@@@@@@@@@@@@@@@@@@@@@@@@@@@@@@@@@@@@@@@@@@@@@@@@@@@@
